444444444444444444444444444444444444444444444444444444444444444444444444444
300400000000000000000000000000060000000000000000000000000000000000000000003
300440000000000000000000000044444400000000000000000000000000000000000000703
304444400000000000000000044440000040000000000000000000000000000000000000003
304000400000000000000000040000000044400000000000000000000000000000000000403
300000000000000000000000440000000000440000000000000000000000000000000004403
300000000000000000000000400000000000040000000000000000000000000000000000403
300000000000000000000000400000000000040000000000000000000000000000000000403
300000000000000000000000400000000000044000000000000000000000000000000000403
300000000000000000000000400005500000004000000000000000000000000000000000403
300000000000000000000000000005555000000000000000000000000000000000000000403
300000000000000000000000000005005000000000000000000000000000000000000004403
300000000000000000600000000005055000000000000000000000000000000000000004003
300000000000000004440000000005555000000000000000000600000000000000006004003
300600000000000004044000000000050000000000000000333333000000000000044444003
304444000000000004004000006000000000060000333333300003333000600000440000003
304404400000000000000000002220000000555550330333333300033333333333400000003
300400400000000000000000020022000005500005300000330333300033300000300000003
300000000000000000000000200002200055000000500000033303330000030000300000003
300000000000000002000000220000200500000000500000000030030000003000000000003
300000000000000222000000200000200500000000500000000030000000003000000000003
300000000033000202000002222222200550000000500333300030000000003000000000003
300000000033330200200000000000000050000005003300330030000000003000000000003
300000000033033333300600000000000005555550003300033330000000003000000000003
300000000003000000222222000000000000055000000333300000000000003000000000003
300003060003000000300002200000000000050000000000330000000000030000000000003
300003333333000000300000222000000000050000000000003300000003300000000000003
300033000030000000300000002000000000050000000000000030000330000000000000003
300030000030000000300000002000000000050000000000000033333000000000000000003
300030000030000000300000002000000000050000000000000030000000000011110000003
300030000030000000300000002200000000050000000000000000000000001100001000003
300330000030000000333330000200000000050000000000000000000000010000001000003
300300000030000000000030002201000000050000000000011110000001100000001000003
300300000030000000000030002011100000050000000000110011000110000000001110003
300300000131000000000030111110010000051100001111100001101000000000001011103
300311011130110000011111000000011001110011111011000000110000000000000000103
300111110000011011110000000000001110000000000000000000000000000000000000103
300100000000001100000000000000000000000000000000000000000000000000000001111
111111111111111111111111111111111111111111111111111111111111111111111111111
555555555555555555555555555555555555555555555555555555555555555555555555555
