4444444444444444444444444444444444444444
3000000000000000000000000000000000000003
3000000600000000000000000110000000000703
3000004444000000011000000010000000000003
3000044004400000001100000001600000000003
3000040000400000000106000000110000000003
3000040000400000000011000000000000000003
3000000000000000000001100000000000011003
3000000000000000000000110000000000010003
3000000440000444000000011600000000000003
3000004444444400000000001110000000000003
3000440004400000000000000011000500000003
3000400000000006000000000000005500000003
3000000000000333300000000000055000000003
3000000000333000030000000000650000000003
3000000000000000003006000005550000000003
3000000000000000003333300005000000000003
3000000000000000000000000055000000000003
3000000600000000000000000550000000000003
3002222222220000000600000000000000000003
5555555555555555555555555555555555555555
